date,category,debit,credit,balance
2024-09-11 01:33:42+00:00,Phone,3.0,0.0,4997.0
2024-09-11 02:18:44+00:00,Transport,0.5,0.0,4996.5
2024-09-11 04:06:22+00:00,Market,14.0,0.0,4982.5
2024-09-11 08:37:19+00:00,Events,50.0,0.0,4932.5
2024-09-11 09:05:52+00:00,Taxi,6.0,0.0,4926.5
2024-09-11 10:28:50+00:00,Phone,12.0,0.0,4914.5
2024-09-11 14:07:41+00:00,Health,6.0,0.0,4908.5
2024-09-11 14:29:43+00:00,Coffe,8.0,0.0,4900.5
2024-09-11 18:18:23+00:00,Transport,0.5,0.0,4900.0
2024-09-11 19:30:18+00:00,Communal,180.0,0.0,4720.0
2024-09-12 02:15:51+00:00,Transport,0.5,0.0,4719.5
2024-09-12 04:03:03+00:00,Market,4.1,0.0,4715.4
2024-09-12 06:08:25+00:00,Restuarant,8.1,0.0,4707.3
2024-09-12 09:00:00+00:00,Coffe,6.0,0.0,4701.3
2024-09-12 12:56:21+00:00,Restuarant,7.2,0.0,4694.1
2024-09-12 14:15:57+00:00,Coffe,5.6,0.0,4688.5
2024-09-12 17:00:05+00:00,Transport,0.5,0.0,4688.0
2024-09-12 17:41:51+00:00,Market,4.0,0.0,4684.0
2024-09-13 04:09:00+00:00,Coffe,21.0,0.0,4663.0
2024-09-13 04:55:16+00:00,Taxi,4.0,0.0,4659.0
2024-09-13 08:45:33+00:00,Transport,0.5,0.0,4658.5
2024-09-13 09:38:22+00:00,Business lunch,12.0,0.0,4646.5
2024-09-13 14:17:53+00:00,Coffe,7.4,0.0,4639.1
2024-09-14 04:06:45+00:00,Transport,0.5,0.0,4638.6
2024-09-14 04:06:48+00:00,Market,12.1,0.0,4626.5
2024-09-14 04:06:51+00:00,Taxi,2.5,0.0,4624.0
2024-09-14 04:06:56+00:00,Coffe,10.0,0.0,4614.0
2024-09-14 07:41:25+00:00,Phone,1.0,0.0,4613.0
2024-09-14 12:05:16+00:00,Restuarant,118.0,0.0,4495.0
2024-09-14 12:32:08+00:00,Transport,0.5,0.0,4494.5
2024-09-14 13:08:17+00:00,Sport,3.0,0.0,4491.5
2024-09-14 13:20:12+00:00,Market,6.0,0.0,4485.5
2024-09-15 06:45:47+00:00,Taxi,2.6,0.0,4482.9
2024-09-15 06:47:02+00:00,Market,14.0,0.0,4468.9
2024-09-15 06:56:13+00:00,Coffe,8.0,0.0,4460.9
2024-09-15 15:52:41+00:00,Tech,510.0,0.0,3950.9
2024-09-15 15:52:46+00:00,Restuarant,178.0,0.0,3772.9
2024-09-16 04:02:17+00:00,Market,11.0,0.0,3761.9
2024-09-16 06:45:27+00:00,Restuarant,8.0,0.0,3753.9
2024-09-16 09:03:35+00:00,Coffe,9.0,0.0,3744.9
2024-09-16 12:40:25+00:00,Market,6.23,0.0,3738.67
2024-09-16 12:46:35+00:00,Restuarant,11.0,0.0,3727.67
2024-09-16 14:19:57+00:00,Coffe,8.0,0.0,3719.67
2024-09-16 17:49:02+00:00,Transport,1.0,0.0,3718.67
2024-09-16 19:06:12+00:00,Market,4.0,0.0,3714.67
2024-09-16 19:06:14+00:00,Health,14.0,0.0,3700.67
2024-09-17 02:57:01+00:00,Transport,1.0,0.0,3699.67
2024-09-17 03:58:32+00:00,Market,8.0,0.0,3691.67
2024-09-17 04:03:30+00:00,Coffe,6.0,0.0,3685.67
2024-09-17 09:30:53+00:00,Business lunch,10.0,0.0,3675.67
2024-09-17 09:59:22+00:00,Phone,15.0,0.0,3660.67
2024-09-17 14:19:51+00:00,Coffe,8.0,0.0,3652.67
2024-09-17 16:03:03+00:00,Taxi,8.0,0.0,3644.67
2024-09-17 18:08:17+00:00,Restuarant,40.0,0.0,3604.67
2024-09-17 19:18:21+00:00,Restuarant,10.0,0.0,3594.67
2024-09-18 04:04:29+00:00,Market,14.0,0.0,3580.67
2024-09-18 09:27:46+00:00,Business lunch,10.0,0.0,3570.67
2024-09-18 09:47:46+00:00,Events,30.0,0.0,3540.67
2024-09-18 14:29:58+00:00,Coffe,6.0,0.0,3534.67
2024-09-18 17:39:24+00:00,Transport,1.0,0.0,3533.67
2024-09-18 18:20:25+00:00,Market,17.0,0.0,3516.67
2024-09-19 03:54:25+00:00,Transport,0.5,0.0,3516.17
2024-09-19 06:28:56+00:00,Restuarant,7.2,0.0,3508.97
2024-09-19 08:29:23+00:00,Phone,12.0,0.0,3496.97
2024-09-19 14:28:19+00:00,business_expenses,24.0,0.0,3472.97
2024-09-19 14:45:20+00:00,Coffe,8.0,0.0,3464.97
2024-09-19 18:09:42+00:00,Market,7.0,0.0,3457.97
2024-09-20 04:34:00+00:00,Transport,1.0,0.0,3456.97
2024-09-20 06:33:51+00:00,Restuarant,8.0,0.0,3448.97
2024-09-20 09:56:18+00:00,Market,7.0,0.0,3441.97
2024-09-20 13:57:27+00:00,Other,10.0,0.0,3431.97
2024-09-20 15:02:11+00:00,Other,10.0,0.0,3421.97
2024-09-20 15:44:23+00:00,Other,12.0,0.0,3409.97
2024-09-21 07:59:49+00:00,Market,7.4,0.0,3402.57
2024-09-21 08:00:07+00:00,Taxi,3.0,0.0,3399.57
2024-09-21 08:31:25+00:00,Coffe,8.0,0.0,3391.57
2024-09-21 12:14:35+00:00,Transport,0.5,0.0,3391.07
2024-09-21 12:54:57+00:00,Market,5.0,0.0,3386.07
2024-09-22 04:10:00+00:00,Market,7.0,0.0,3379.07
2024-09-22 04:10:45+00:00,Taxi,2.6,0.0,3376.47
2024-09-22 05:27:00+00:00,Coffe,8.0,0.0,3368.47
2024-09-22 11:27:12+00:00,Restuarant,48.0,0.0,3320.47
2024-09-22 11:43:13+00:00,Coffe,7.0,0.0,3313.47
2024-09-22 13:26:54+00:00,Transport,1.0,0.0,3312.47
2024-09-23 02:18:06+00:00,Transport,0.5,0.0,3311.97
2024-09-23 04:21:22+00:00,Coffe,16.0,0.0,3295.97
2024-09-23 04:32:41+00:00,Coffe,5.25,0.0,3290.72
2024-09-23 09:44:46+00:00,Business lunch,12.0,0.0,3278.72
2024-09-23 09:44:51+00:00,Market,5.0,0.0,3273.72
2024-09-23 14:15:14+00:00,Coffe,4.5,0.0,3269.22
2024-09-23 16:49:10+00:00,business_expenses,15.0,0.0,3254.22
2024-09-23 17:42:09+00:00,Transport,0.5,0.0,3253.72
2024-09-23 18:37:15+00:00,Market,7.2,0.0,3246.52
2024-09-24 03:44:00+00:00,Market,6.2,0.0,3240.32
2024-09-24 07:44:25+00:00,Taxi,7.0,0.0,3233.32
2024-09-24 14:16:20+00:00,Coffe,7.4,0.0,3225.92
2024-09-24 16:04:17+00:00,Restuarant,12.0,0.0,3213.92
2024-09-24 16:42:43+00:00,Transport,0.5,0.0,3213.42
2024-09-25 02:21:57+00:00,Transport,0.5,0.0,3212.92
2024-09-25 08:26:17+00:00,Restuarant,8.5,0.0,3204.42
2024-09-25 09:05:37+00:00,Coffe,5.25,0.0,3199.17
2024-09-25 15:33:58+00:00,Coffe,4.4,0.0,3194.77
2024-09-25 17:44:30+00:00,Coffe,13.0,0.0,3181.77
2024-09-25 19:37:03+00:00,Transport,0.5,0.0,3181.27
2024-09-26 02:14:06+00:00,Transport,0.5,0.0,3180.77
2024-09-26 03:57:00+00:00,Market,6.5,0.0,3174.27
2024-09-26 06:44:21+00:00,Restuarant,7.2,0.0,3167.07
2024-09-26 09:03:40+00:00,Coffe,8.4,0.0,3158.67
2024-09-26 15:30:11+00:00,Coffe,7.4,0.0,3151.27
2024-09-26 17:14:24+00:00,Transport,0.5,0.0,3150.77
2024-09-26 18:12:16+00:00,Market,9.0,0.0,3141.77
2024-09-27 02:24:07+00:00,Transport,0.5,0.0,3141.27
2024-09-27 03:55:58+00:00,Market,7.0,0.0,3134.27
2024-09-27 06:42:03+00:00,Restuarant,17.1,0.0,3117.17
2024-09-27 09:21:27+00:00,Coffe,8.0,0.0,3109.17
2024-09-27 12:39:39+00:00,Restuarant,8.0,0.0,3101.17
2024-09-27 14:13:16+00:00,Coffe,7.4,0.0,3093.77
2024-09-27 17:06:44+00:00,Transport,0.5,0.0,3093.27
2024-09-28 04:04:41+00:00,Transport,0.5,0.0,3092.77
2024-09-28 05:31:53+00:00,Market,8.0,0.0,3084.77
2024-09-28 05:58:09+00:00,Coffe,13.0,0.0,3071.77
2024-09-28 10:54:02+00:00,Coffe,13.0,0.0,3058.77
2024-09-28 12:52:17+00:00,Transport,0.5,0.0,3058.27
2024-09-28 13:31:37+00:00,Market,8.0,0.0,3050.27
2024-09-29 02:57:07+00:00,Transport,0.5,0.0,3049.77
2024-09-29 04:29:03+00:00,Market,7.4,0.0,3042.37
2024-09-29 04:53:24+00:00,Coffe,15.0,0.0,3027.37
2024-09-29 10:40:38+00:00,Restuarant,8.0,0.0,3019.37
2024-09-29 13:11:41+00:00,Transport,0.5,0.0,3018.87
2024-09-29 13:11:44+00:00,Market,4.8,0.0,3014.07
2024-09-30 01:33:42+00:00,Salary,0.0,7000.0,10014.07
2024-09-30 02:24:37+00:00,Transport,0.5,0.0,10013.57
2024-09-30 04:10:44+00:00,Market,3.75,0.0,10009.82
2024-09-30 06:41:23+00:00,Restuarant,8.0,0.0,10001.82
2024-09-30 10:06:19+00:00,Restuarant,40.0,0.0,9961.82
2024-09-30 14:19:09+00:00,Coffe,4.5,0.0,9957.32
2024-09-30 18:29:56+00:00,Restuarant,145.0,0.0,9812.32
2024-10-01 02:21:22+00:00,Transport,0.5,0.0,9811.82
2024-10-01 03:54:24+00:00,Sport,89.0,0.0,9722.82
2024-10-01 03:54:27+00:00,Sport,20.0,0.0,9702.82
2024-10-01 03:55:38+00:00,Market,0.5,0.0,9702.32
2024-10-01 12:42:23+00:00,Restuarant,55.0,0.0,9647.32
2024-10-01 12:42:29+00:00,Coffe,7.4,0.0,9639.92
2024-10-01 15:05:34+00:00,Transport,0.5,0.0,9639.42
2024-10-01 15:47:59+00:00,Market,18.0,0.0,9621.42
2024-10-01 16:29:17+00:00,Market,1.0,0.0,9620.42
2024-10-01 16:29:19+00:00,Other,20.0,0.0,9600.42
2024-10-02 02:06:00+00:00,Taxi,4.0,0.0,9596.42
2024-10-02 03:52:42+00:00,Market,7.5,0.0,9588.92
2024-10-02 08:33:27+00:00,Restuarant,7.0,0.0,9581.92
2024-10-02 13:04:49+00:00,Events,200.0,0.0,9381.92
2024-10-02 13:48:00+00:00,Taxi,7.0,0.0,9374.92
2024-10-02 17:27:20+00:00,Other,70.0,0.0,9304.92
2024-10-03 03:57:44+00:00,Market,7.8,0.0,9297.12
2024-10-03 07:42:56+00:00,Restuarant,7.2,0.0,9289.92
2024-10-03 09:08:03+00:00,Coffe,5.25,0.0,9284.67
2024-10-03 13:00:31+00:00,Tech,5.6,0.0,9279.07
2024-10-03 14:20:00+00:00,Coffe,15.0,0.0,9264.07
2024-10-03 16:24:48+00:00,Transport,0.5,0.0,9263.57
2024-10-04 02:21:58+00:00,Transport,0.5,0.0,9263.07
2024-10-04 04:00:59+00:00,Market,7.0,0.0,9256.07
2024-10-04 09:16:11+00:00,Coffe,9.0,0.0,9247.07
2024-10-04 09:45:35+00:00,business_expenses,17.0,0.0,9230.07
2024-10-04 09:56:51+00:00,Restuarant,11.0,0.0,9219.07
2024-10-04 14:25:32+00:00,Coffe,7.4,0.0,9211.67
2024-10-04 18:33:07+00:00,Transport,0.5,0.0,9211.17
2024-10-04 19:08:29+00:00,Market,5.55,0.0,9205.62
2024-10-05 06:17:35+00:00,Transport,0.5,0.0,9205.12
2024-10-05 07:01:41+00:00,Coffe,15.0,0.0,9190.12
2024-10-05 11:42:32+00:00,Learning,33.0,0.0,9157.12
2024-10-05 11:58:12+00:00,Restuarant,8.0,0.0,9149.12
2024-10-05 12:43:01+00:00,Transport,0.5,0.0,9148.62
2024-10-05 13:00:08+00:00,Learning,15.0,0.0,9133.62
2024-10-06 02:25:06+00:00,Transport,0.5,0.0,9133.12
2024-10-06 04:10:55+00:00,Market,0.5,0.0,9132.62
2024-10-06 04:38:00+00:00,Coffe,15.0,0.0,9117.62
2024-10-06 09:38:15+00:00,Coffe,15.0,0.0,9102.62
2024-10-06 11:56:17+00:00,Transport,0.5,0.0,9102.12
2024-10-06 12:43:37+00:00,Market,2.5,0.0,9099.62
2024-10-06 19:33:10+00:00,Phone,16.0,0.0,9083.62
2024-10-07 02:57:51+00:00,Transport,0.5,0.0,9083.12
2024-10-07 04:01:12+00:00,Market,7.0,0.0,9076.12
2024-10-07 07:24:13+00:00,Restuarant,9.0,0.0,9067.12
2024-10-07 08:12:30+00:00,Coffe,6.4,0.0,9060.72
2024-10-07 13:33:26+00:00,Coffe,7.0,0.0,9053.72
2024-10-07 13:58:59+00:00,Coffe,7.2,0.0,9046.52
2024-10-07 17:45:11+00:00,Transport,0.5,0.0,9046.02
2024-10-07 18:22:19+00:00,Market,16.0,0.0,9030.02
2024-10-08 02:26:30+00:00,Transport,0.5,0.0,9029.52
2024-10-08 04:08:16+00:00,Market,7.4,0.0,9022.12
2024-10-08 07:20:04+00:00,Restuarant,11.0,0.0,9011.12
2024-10-08 08:39:10+00:00,Clothing,150.0,0.0,8861.12
2024-10-08 08:52:52+00:00,Market,8.0,0.0,8853.12
2024-10-08 13:34:38+00:00,Coffe,15.0,0.0,8838.12
2024-10-08 14:41:24+00:00,Taxi,7.0,0.0,8831.12
2024-10-08 16:38:38+00:00,Transport,0.5,0.0,8830.62
2024-10-09 05:07:00+00:00,Transport,0.5,0.0,8830.12
2024-10-09 07:07:45+00:00,Restuarant,23.0,0.0,8807.12
2024-10-09 09:41:10+00:00,Coffe,15.0,0.0,8792.12
2024-10-09 12:50:48+00:00,Coffe,8.0,0.0,8784.12
2024-10-09 17:40:13+00:00,Transport,1.5,0.0,8782.62
2024-10-09 18:23:10+00:00,Market,5.5,0.0,8777.12
2024-10-10 07:28:32+00:00,Learning,50.0,0.0,8727.12
2024-10-10 07:36:10+00:00,Transport,1.0,0.0,8726.12
2024-10-10 08:32:46+00:00,Coffe,15.0,0.0,8711.12
2024-10-10 13:45:09+00:00,Coffe,8.0,0.0,8703.12
2024-10-10 16:37:09+00:00,Transport,0.5,0.0,8702.62
2024-10-11 07:17:38+00:00,Transport,0.5,0.0,8702.12
2024-10-11 08:34:21+00:00,Market,8.0,0.0,8694.12
2024-10-11 08:41:41+00:00,Phone,3.0,0.0,8691.12
2024-10-11 09:50:10+00:00,Coffe,15.0,0.0,8676.12
2024-10-11 13:33:11+00:00,Coffe,8.0,0.0,8668.12
2024-10-11 16:31:39+00:00,Transport,0.5,0.0,8667.62
2024-10-11 17:14:36+00:00,Market,5.3,0.0,8662.32
2024-10-12 02:27:35+00:00,Transport,0.5,0.0,8661.82
2024-10-12 04:10:15+00:00,Market,7.4,0.0,8654.42
2024-10-12 10:03:24+00:00,Restuarant,5.8,0.0,8648.62
2024-10-12 10:03:25+00:00,Coffe,5.6,0.0,8643.02
2024-10-12 12:40:57+00:00,Transport,0.5,0.0,8642.52
2024-10-12 14:01:56+00:00,Other,10.0,0.0,8632.52
2024-10-13 03:02:40+00:00,Transport,0.5,0.0,8632.02
2024-10-13 04:15:34+00:00,Market,8.3,0.0,8623.72
2024-10-13 04:35:30+00:00,Taxi,2.5,0.0,8621.22
2024-10-13 04:35:32+00:00,Coffe,13.0,0.0,8608.22
2024-10-13 10:51:50+00:00,Transport,0.5,0.0,8607.72
2024-10-13 11:41:01+00:00,Restuarant,22.0,0.0,8585.72
2024-10-13 11:48:31+00:00,Transport,0.5,0.0,8585.22
2024-10-13 12:27:37+00:00,Market,8.0,0.0,8577.22
2024-10-14 02:02:01+00:00,Taxi,4.1,0.0,8573.12
2024-10-14 03:53:15+00:00,Market,11.0,0.0,8562.12
2024-10-14 06:49:48+00:00,Restuarant,7.2,0.0,8554.92
2024-10-14 11:53:58+00:00,Taxi,5.1,0.0,8549.82
2024-10-14 12:48:46+00:00,Transport,0.5,0.0,8549.32
2024-10-14 13:38:54+00:00,Coffe,13.0,0.0,8536.32
2024-10-14 17:42:30+00:00,Transport,0.5,0.0,8535.82
2024-10-15 02:16:05+00:00,Transport,0.5,0.0,8535.32
2024-10-15 03:59:17+00:00,Market,7.7,0.0,8527.62
2024-10-15 07:30:43+00:00,Restuarant,14.0,0.0,8513.62
2024-10-15 14:11:43+00:00,Coffe,5.6,0.0,8508.02
2024-10-15 17:25:25+00:00,Transport,0.5,0.0,8507.52
2024-10-15 18:06:36+00:00,Market,5.12,0.0,8502.4
2024-10-16 02:24:20+00:00,Transport,0.5,0.0,8501.9
2024-10-16 04:06:45+00:00,Market,7.4,0.0,8494.5
2024-10-16 08:45:20+00:00,Restuarant,10.0,0.0,8484.5
2024-10-16 13:30:51+00:00,Coffe,5.6,0.0,8478.9
2024-10-17 02:21:07+00:00,Transport,0.5,0.0,8478.4
2024-10-17 04:03:19+00:00,Market,10.0,0.0,8468.4
2024-10-17 08:35:29+00:00,Restuarant,10.0,0.0,8458.4
2024-10-17 08:40:28+00:00,Learning,30.0,0.0,8428.4
2024-10-17 13:34:26+00:00,Transport,0.5,0.0,8427.9
2024-10-17 13:47:21+00:00,Market,10.0,0.0,8417.9
2024-10-18 02:32:10+00:00,Transport,0.5,0.0,8417.4
2024-10-18 04:02:21+00:00,Market,8.8,0.0,8408.6
2024-10-18 08:50:41+00:00,Restuarant,10.0,0.0,8398.6
2024-10-18 13:26:57+00:00,Coffe,13.0,0.0,8385.6
2024-10-18 18:57:51+00:00,Market,6.0,0.0,8379.6
2024-10-19 09:03:00+00:00,Transport,0.5,0.0,8379.1
2024-10-19 09:38:25+00:00,Coffe,13.0,0.0,8366.1
2024-10-19 13:45:50+00:00,Coffe,5.6,0.0,8360.5
2024-10-19 17:55:54+00:00,Transport,0.5,0.0,8360.0
2024-10-19 18:41:58+00:00,Market,22.0,0.0,8338.0
2024-10-20 03:15:06+00:00,Transport,1.0,0.0,8337.0
2024-10-20 04:36:24+00:00,Taxi,2.6,0.0,8334.4
2024-10-20 04:37:49+00:00,Market,9.0,0.0,8325.4
2024-10-20 04:54:21+00:00,Coffe,13.0,0.0,8312.4
2024-10-20 07:12:48+00:00,Phone,5.0,0.0,8307.4
2024-10-20 10:40:05+00:00,Restuarant,24.0,0.0,8283.4
2024-10-20 11:15:57+00:00,Other,12.0,0.0,8271.4
2024-10-20 11:56:34+00:00,Other,10.0,0.0,8261.4
2024-10-20 12:54:13+00:00,Market,6.0,0.0,8255.4
2024-10-21 09:13:07+00:00,Phone,25.0,0.0,8230.4
2024-10-21 09:20:29+00:00,Transport,0.5,0.0,8229.9
2024-10-21 09:32:56+00:00,Transport,0.5,0.0,8229.4
2024-10-21 10:14:55+00:00,Coffe,13.0,0.0,8216.4
2024-10-21 12:32:37+00:00,Learning,50.0,0.0,8166.4
2024-10-21 13:14:56+00:00,Coffe,15.0,0.0,8151.4
2024-10-21 18:12:15+00:00,Transport,0.5,0.0,8150.9
2024-10-21 18:24:25+00:00,Market,6.0,0.0,8144.9
2024-10-22 06:21:47+00:00,Taxi,3.0,0.0,8141.9
2024-10-22 06:25:47+00:00,Coffe,13.0,0.0,8128.9
2024-10-22 11:46:29+00:00,Coffe,5.6,0.0,8123.3
2024-10-22 11:46:32+00:00,Restuarant,60.0,0.0,8063.3
2024-10-22 16:53:41+00:00,Market,3.0,0.0,8060.3
2024-10-23 03:35:16+00:00,Transport,0.5,0.0,8059.8
2024-10-23 05:19:13+00:00,Taxi,3.0,0.0,8056.8
2024-10-23 05:21:07+00:00,Market,11.0,0.0,8045.8
2024-10-23 05:40:30+00:00,Coffe,5.6,0.0,8040.2
2024-10-23 09:42:33+00:00,Coffe,13.0,0.0,8027.2
2024-10-23 12:38:37+00:00,Coffe,5.6,0.0,8021.6
2024-10-23 18:13:26+00:00,Market,21.0,0.0,8000.6
2024-10-24 07:59:00+00:00,Transport,0.5,0.0,8000.1
2024-10-24 10:59:03+00:00,Coffe,13.0,0.0,7987.1
2024-10-24 10:59:05+00:00,Market,0.5,0.0,7986.6
2024-10-24 19:40:35+00:00,Market,3.0,0.0,7983.6
2024-10-24 19:40:43+00:00,Communal,100.0,0.0,7883.6
2024-10-25 08:37:08+00:00,Transport,0.5,0.0,7883.1
2024-10-25 09:15:31+00:00,Market,5.64,0.0,7877.46
2024-10-25 10:22:26+00:00,Market,10.0,0.0,7867.46
2024-10-25 10:59:46+00:00,Coffe,6.0,0.0,7861.46
2024-10-25 15:39:55+00:00,Coffe,13.0,0.0,7848.46
2024-10-25 18:21:18+00:00,Transport,0.5,0.0,7847.96
2024-10-26 03:12:56+00:00,Transport,1.0,0.0,7846.96
2024-10-26 04:53:56+00:00,Transport,0.5,0.0,7846.46
2024-10-26 05:43:24+00:00,Other,15.0,0.0,7831.46
2024-10-26 06:29:58+00:00,Coffe,13.0,0.0,7818.46
2024-10-26 10:20:17+00:00,Market,5.0,0.0,7813.46
2024-10-27 06:41:46+00:00,Transport,1.0,0.0,7812.46
2024-10-27 08:17:23+00:00,Market,7.4,0.0,7805.06
2024-10-27 08:17:25+00:00,Taxi,3.0,0.0,7802.06
2024-10-27 08:36:18+00:00,Coffe,13.0,0.0,7789.06
2024-10-27 13:35:49+00:00,Restuarant,23.0,0.0,7766.06
2024-10-27 14:13:12+00:00,Transport,0.5,0.0,7765.56
2024-10-27 15:28:32+00:00,Other,10.0,0.0,7755.56
2024-10-27 15:28:33+00:00,Market,28.0,0.0,7727.56
2024-10-28 03:36:38+00:00,Taxi,9.3,0.0,7718.26
2024-10-28 06:45:49+00:00,Restuarant,7.2,0.0,7711.06
2024-10-28 08:25:26+00:00,Clothing,126.0,0.0,7585.06
2024-10-28 08:27:08+00:00,Coffe,6.4,0.0,7578.66
2024-10-28 14:21:11+00:00,Restuarant,8.0,0.0,7570.66
2024-10-28 14:42:06+00:00,Coffe,5.0,0.0,7565.66
2024-10-29 02:19:15+00:00,Transport,0.5,0.0,7565.16
2024-10-29 03:58:00+00:00,Market,10.0,0.0,7555.16
2024-10-29 07:33:17+00:00,Restuarant,11.0,0.0,7544.16
2024-10-29 08:07:03+00:00,Coffe,6.4,0.0,7537.76
2024-10-29 13:36:39+00:00,Coffe,13.0,0.0,7524.76
2024-10-29 18:24:24+00:00,Market,7.0,0.0,7517.76
2024-10-30 02:23:01+00:00,Transport,0.5,0.0,7517.26
2024-10-30 03:59:28+00:00,Market,8.0,0.0,7509.26
2024-10-30 07:06:20+00:00,Restuarant,24.0,0.0,7485.26
2024-10-30 08:07:09+00:00,Coffe,6.4,0.0,7478.86
2024-10-30 11:01:15+00:00,Events,10.0,0.0,7468.86
2024-10-30 17:45:55+00:00,Transport,1.0,0.0,7467.86
2024-10-30 18:15:49+00:00,Restuarant,17.0,0.0,7450.86
2024-10-31 01:33:42+00:00,Salary,0.0,7000.0,14450.86
2024-10-31 02:12:28+00:00,Sport,89.0,0.0,14361.86
2024-10-31 02:25:26+00:00,Transport,1.0,0.0,14360.86
2024-10-31 03:58:59+00:00,Market,9.0,0.0,14351.86
2024-10-31 08:02:18+00:00,Coffe,6.4,0.0,14345.46
2024-10-31 14:21:46+00:00,Coffe,12.0,0.0,14333.46
2024-10-31 14:32:45+00:00,Events,20.0,0.0,14313.46
2024-10-31 19:12:15+00:00,Market,24.0,0.0,14289.46
2024-11-01 03:51:30+00:00,Market,7.4,0.0,14282.06
2024-11-01 06:01:24+00:00,Restuarant,8.0,0.0,14274.06
2024-11-01 08:07:07+00:00,Coffe,6.4,0.0,14267.66
2024-11-01 13:25:35+00:00,Coffe,11.0,0.0,14256.66
2024-11-01 17:39:54+00:00,Transport,0.5,0.0,14256.16
2024-11-02 06:49:15+00:00,Transport,0.5,0.0,14255.66
2024-11-02 07:49:19+00:00,Taxi,4.1,0.0,14251.56
2024-11-02 08:55:31+00:00,Sport,20.0,0.0,14231.56
2024-11-02 09:00:15+00:00,Market,9.0,0.0,14222.56
2024-11-02 09:11:46+00:00,Learning,20.0,0.0,14202.56
2024-11-02 10:21:56+00:00,Coffe,5.6,0.0,14196.96
2024-11-02 14:03:57+00:00,Coffe,10.0,0.0,14186.96
2024-11-02 18:33:29+00:00,Transport,0.5,0.0,14186.46
2024-11-02 19:15:39+00:00,Market,19.0,0.0,14167.46
2024-11-03 03:11:25+00:00,Learning,8.0,0.0,14159.46
2024-11-03 04:56:15+00:00,Transport,0.5,0.0,14158.96
2024-11-03 07:03:24+00:00,Coffe,5.6,0.0,14153.36
2024-11-03 10:25:53+00:00,Transport,0.5,0.0,14152.86
2024-11-03 12:14:43+00:00,Other,25.0,0.0,14127.86
2024-11-03 15:18:03+00:00,Restuarant,52.0,0.0,14075.86
2024-11-03 15:20:10+00:00,Transport,0.5,0.0,14075.36
2024-11-04 10:14:39+00:00,Phone,20.0,0.0,14055.36
2024-11-04 11:54:55+00:00,Transport,0.5,0.0,14054.86
2024-11-04 13:39:38+00:00,Coffe,13.0,0.0,14041.86
2024-11-04 18:04:59+00:00,Transport,1.0,0.0,14040.86
2024-11-04 18:20:07+00:00,Market,1.0,0.0,14039.86
2024-11-05 08:35:30+00:00,Learning,20.0,0.0,14019.86
2024-11-05 10:11:15+00:00,Transport,0.5,0.0,14019.36
2024-11-05 10:20:03+00:00,Transport,0.5,0.0,14018.86
2024-11-05 11:53:25+00:00,Market,7.4,0.0,14011.46
2024-11-05 12:19:11+00:00,Coffe,5.6,0.0,14005.86
2024-11-05 15:26:25+00:00,Coffe,5.6,0.0,14000.26
2024-11-05 18:23:23+00:00,Market,6.28,0.0,13993.98
2024-11-06 07:43:26+00:00,Transport,0.5,0.0,13993.48
2024-11-06 09:11:40+00:00,Market,7.4,0.0,13986.08
2024-11-06 09:47:02+00:00,Market,13.0,0.0,13973.08
2024-11-06 12:53:59+00:00,Coffe,10.0,0.0,13963.08
2024-11-06 14:32:15+00:00,Restuarant,6.5,0.0,13956.58
2024-11-06 14:36:16+00:00,Coffe,4.5,0.0,13952.08
2024-11-06 16:09:21+00:00,Transport,0.5,0.0,13951.58
2024-11-06 16:47:44+00:00,Market,12.0,0.0,13939.58
2024-11-07 09:18:07+00:00,Learning,6.4,0.0,13933.18
2024-11-07 09:18:24+00:00,Transport,0.5,0.0,13932.68
2024-11-07 10:55:59+00:00,Market,8.0,0.0,13924.68
2024-11-07 11:23:56+00:00,Coffe,13.0,0.0,13911.68
2024-11-07 14:48:07+00:00,Restuarant,6.5,0.0,13905.18
2024-11-07 15:04:22+00:00,Transport,0.5,0.0,13904.68
2024-11-07 15:52:14+00:00,Market,16.0,0.0,13888.68
2024-11-08 08:54:08+00:00,Other,20.0,0.0,13868.68
2024-11-08 10:06:29+00:00,Transport,0.5,0.0,13868.18
2024-11-08 11:02:35+00:00,Coffe,13.0,0.0,13855.18
2024-11-08 14:52:23+00:00,Restuarant,6.5,0.0,13848.68
2024-11-08 15:06:03+00:00,Transport,0.5,0.0,13848.18
2024-11-08 16:00:45+00:00,Market,9.25,0.0,13838.93
2024-11-09 07:56:37+00:00,Transport,1.0,0.0,13837.93
2024-11-09 10:07:10+00:00,Coffe,15.0,0.0,13822.93
2024-11-09 11:17:02+00:00,Transport,0.5,0.0,13822.43
2024-11-09 15:35:45+00:00,Restuarant,35.0,0.0,13787.43
2024-11-09 16:17:13+00:00,Market,15.0,0.0,13772.43
2024-11-10 04:14:20+00:00,Transport,0.5,0.0,13771.93
2024-11-10 06:18:49+00:00,Market,7.4,0.0,13764.53
2024-11-10 06:22:56+00:00,Coffe,6.0,0.0,13758.53
2024-11-10 10:43:14+00:00,Learning,50.0,0.0,13708.53
2024-11-10 13:36:44+00:00,Coffe,5.6,0.0,13702.93
2024-11-10 16:51:09+00:00,Transport,0.5,0.0,13702.43
2024-11-11 08:08:03+00:00,Transport,0.5,0.0,13701.93
2024-11-11 08:49:56+00:00,Market,13.0,0.0,13688.93
2024-11-11 09:15:13+00:00,Coffe,5.6,0.0,13683.33
2024-11-11 12:11:31+00:00,Restuarant,6.5,0.0,13676.83
2024-11-11 12:34:24+00:00,Transport,0.5,0.0,13676.33
2024-11-11 13:18:58+00:00,Market,16.0,0.0,13660.33
2024-11-11 13:39:59+00:00,Communal,150.0,0.0,13510.33
2024-11-12 09:19:00+00:00,Transport,0.5,0.0,13509.83
2024-11-12 10:18:24+00:00,Coffe,5.6,0.0,13504.23
2024-11-12 11:02:02+00:00,Coffe,7.2,0.0,13497.03
2024-11-12 13:10:52+00:00,Coffe,11.0,0.0,13486.03
2024-11-12 15:32:23+00:00,Restuarant,6.5,0.0,13479.53
2024-11-12 15:45:08+00:00,Transport,0.5,0.0,13479.03
2024-11-12 16:20:19+00:00,Market,8.4,0.0,13470.63
2024-11-13 06:38:00+00:00,Transport,0.5,0.0,13470.13
2024-11-13 07:38:51+00:00,Market,8.0,0.0,13462.13
2024-11-13 08:40:19+00:00,Market,7.0,0.0,13455.13
2024-11-13 09:09:52+00:00,Coffe,5.6,0.0,13449.53
2024-11-13 11:53:19+00:00,Coffe,13.0,0.0,13436.53
2024-11-13 16:49:43+00:00,Restuarant,6.5,0.0,13430.03
2024-11-13 17:21:00+00:00,Transport,0.5,0.0,13429.53
2024-11-13 18:21:49+00:00,Market,3.0,0.0,13426.53
2024-11-14 03:23:00+00:00,Transport,0.5,0.0,13426.03
2024-11-14 03:30:22+00:00,Transport,0.5,0.0,13425.53
2024-11-14 05:02:04+00:00,Market,15.0,0.0,13410.53
2024-11-14 05:02:06+00:00,Coffe,13.0,0.0,13397.53
2024-11-14 09:02:25+00:00,Coffe,5.6,0.0,13391.93
2024-11-14 12:24:29+00:00,Transport,0.5,0.0,13391.43
2024-11-14 15:22:01+00:00,Transport,0.5,0.0,13390.93
2024-11-14 15:22:06+00:00,Restuarant,28.0,0.0,13362.93
2024-11-15 07:35:36+00:00,Transport,1.0,0.0,13361.93
2024-11-15 09:21:25+00:00,Market,8.0,0.0,13353.93
2024-11-15 09:50:30+00:00,Coffe,6.0,0.0,13347.93
2024-11-15 12:32:31+00:00,Coffe,13.0,0.0,13334.93
2024-11-15 17:02:01+00:00,Restuarant,8.5,0.0,13326.43
2024-11-15 18:30:01+00:00,Restuarant,37.0,0.0,13289.43
2024-11-15 18:47:50+00:00,Transport,0.5,0.0,13288.93
2024-11-16 07:17:58+00:00,Transport,0.5,0.0,13288.43
2024-11-16 09:13:04+00:00,Coffe,13.0,0.0,13275.43
2024-11-16 12:01:30+00:00,Coffe,6.0,0.0,13269.43
2024-11-16 14:03:37+00:00,Transport,0.5,0.0,13268.93
2024-11-16 17:12:39+00:00,Transport,1.0,0.0,13267.93
2024-11-16 17:12:43+00:00,Restuarant,40.0,0.0,13227.93
2024-11-17 09:14:45+00:00,Transport,1.0,0.0,13226.93
2024-11-17 10:00:02+00:00,Coffe,13.0,0.0,13213.93
2024-11-17 13:28:04+00:00,Coffe,5.6,0.0,13208.33
2024-11-17 15:40:39+00:00,Transport,1.0,0.0,13207.33
2024-11-17 16:24:07+00:00,Market,22.0,0.0,13185.33
2024-11-18 09:18:10+00:00,Transport,1.0,0.0,13184.33
2024-11-18 11:14:08+00:00,Market,14.0,0.0,13170.33
2024-11-18 16:12:19+00:00,Coffe,20.0,0.0,13150.33
2024-11-18 18:02:04+00:00,Transport,0.5,0.0,13149.83
2024-11-18 18:45:33+00:00,Market,9.0,0.0,13140.83
2024-11-19 10:10:56+00:00,Transport,0.5,0.0,13140.33
2024-11-19 12:03:51+00:00,Market,0.5,0.0,13139.83
2024-11-19 12:26:56+00:00,Coffe,6.0,0.0,13133.83
2024-11-19 13:16:11+00:00,Coffe,18.0,0.0,13115.83
2024-11-19 16:22:36+00:00,Restuarant,57.0,0.0,13058.83
2024-11-19 17:42:02+00:00,Transport,0.5,0.0,13058.33
2024-11-20 08:56:03+00:00,Transport,1.0,0.0,13057.33
2024-11-20 11:40:27+00:00,Restuarant,9.0,0.0,13048.33
2024-11-20 11:47:56+00:00,Coffe,6.0,0.0,13042.33
2024-11-20 15:35:03+00:00,Coffe,5.6,0.0,13036.73
2024-11-20 18:25:32+00:00,Restuarant,8.0,0.0,13028.73
2024-11-20 18:33:20+00:00,Transport,0.5,0.0,13028.23
2024-11-20 19:18:24+00:00,Market,4.5,0.0,13023.73
2024-11-21 09:43:50+00:00,Other,15.0,0.0,13008.73
2024-11-21 10:47:37+00:00,Transport,1.0,0.0,13007.73
2024-11-21 11:46:51+00:00,Coffe,6.0,0.0,13001.73
2024-11-21 13:32:56+00:00,business_expenses,17.0,0.0,12984.73
2024-11-21 13:54:53+00:00,Learning,50.0,0.0,12934.73
2024-11-21 15:07:04+00:00,Restuarant,7.0,0.0,12927.73
2024-11-21 15:11:09+00:00,Coffe,15.0,0.0,12912.73
2024-11-21 19:16:23+00:00,Market,8.0,0.0,12904.73
2024-11-21 19:38:56+00:00,Transport,0.5,0.0,12904.23
2024-11-22 03:05:21+00:00,Transport,1.0,0.0,12903.23
2024-11-22 05:04:37+00:00,Market,7.4,0.0,12895.83
2024-11-22 05:37:40+00:00,Coffe,6.0,0.0,12889.83
2024-11-22 10:57:04+00:00,Restuarant,15.0,0.0,12874.83
2024-11-22 10:57:05+00:00,Coffe,16.0,0.0,12858.83
2024-11-22 13:45:12+00:00,Coffe,7.0,0.0,12851.83
2024-11-22 17:15:06+00:00,Transport,0.5,0.0,12851.33
2024-11-22 17:53:08+00:00,Market,5.0,0.0,12846.33
2024-11-23 06:21:40+00:00,Restuarant,18.0,0.0,12828.33
2024-11-23 07:08:06+00:00,Coffe,6.0,0.0,12822.33
2024-11-23 11:07:41+00:00,Taxi,3.0,0.0,12819.33
2024-11-23 12:00:41+00:00,Restuarant,10.0,0.0,12809.33
2024-11-24 08:03:45+00:00,Transport,0.5,0.0,12808.83
2024-11-24 09:43:16+00:00,Coffe,6.0,0.0,12802.83
2024-11-24 11:05:07+00:00,Learning,30.0,0.0,12772.83
2024-11-24 14:43:21+00:00,Restuarant,43.0,0.0,12729.83
2024-11-24 14:43:23+00:00,Transport,0.5,0.0,12729.33
2024-11-25 06:49:36+00:00,Taxi,7.0,0.0,12722.33
2024-11-25 09:30:06+00:00,Taxi,2.5,0.0,12719.83
2024-11-25 09:30:10+00:00,Phone,5.0,0.0,12714.83
2024-11-27 08:16:32+00:00,Taxi,4.0,0.0,12710.83
2024-11-27 09:16:52+00:00,Health,14.0,0.0,12696.83
2024-11-27 09:16:54+00:00,Market,20.0,0.0,12676.83
2024-11-27 12:21:02+00:00,Transport,1.5,0.0,12675.33
2024-11-27 13:08:55+00:00,Coffe,9.0,0.0,12666.33
2024-11-27 18:36:28+00:00,Market,16.0,0.0,12650.33
2024-11-28 10:15:46+00:00,Taxi,4.1,0.0,12646.23
2024-11-28 11:28:06+00:00,Coffe,5.0,0.0,12641.23
2024-11-28 12:45:12+00:00,Coffe,10.0,0.0,12631.23
2024-11-28 16:04:07+00:00,Taxi,7.0,0.0,12624.23
2024-11-28 16:06:40+00:00,Coffe,12.0,0.0,12612.23
2024-11-29 01:33:42+00:00,Salary,0.0,7000.0,19612.23
2024-11-29 10:11:23+00:00,Transport,1.0,0.0,19611.23
2024-11-29 11:04:28+00:00,Market,7.0,0.0,19604.23
2024-11-29 11:04:32+00:00,Taxi,4.2,0.0,19600.03
2024-11-29 11:37:15+00:00,Coffe,6.0,0.0,19594.03
2024-11-29 13:33:05+00:00,Coffe,7.0,0.0,19587.03
2024-11-29 16:07:37+00:00,Market,26.0,0.0,19561.03
2024-11-29 16:08:19+00:00,Taxi,3.0,0.0,19558.03
2024-11-30 07:17:57+00:00,Coffe,15.0,0.0,19543.03
2024-11-30 10:07:10+00:00,Transport,1.0,0.0,19542.03
2024-11-30 10:55:12+00:00,Coffe,15.0,0.0,19527.03
2024-11-30 15:04:45+00:00,Transport,0.5,0.0,19526.53
2024-11-30 15:52:36+00:00,Market,10.0,0.0,19516.53
2024-12-01 06:08:38+00:00,Transport,1.0,0.0,19515.53
2024-12-01 07:27:00+00:00,Coffe,15.0,0.0,19500.53
2024-12-01 10:17:54+00:00,Restuarant,5.0,0.0,19495.53
2024-12-01 10:22:08+00:00,Coffe,5.6,0.0,19489.93
2024-12-01 14:23:30+00:00,Transport,0.5,0.0,19489.43
2024-12-01 14:56:11+00:00,Phone,19.0,0.0,19470.43
2024-12-02 03:19:55+00:00,Transport,1.0,0.0,19469.43
2024-12-02 08:46:13+00:00,Transport,1.0,0.0,19468.43
2024-12-02 09:18:37+00:00,Business lunch,10.0,0.0,19458.43
2024-12-02 09:22:44+00:00,Learning,20.0,0.0,19438.43
2024-12-02 13:07:53+00:00,Coffe,5.6,0.0,19432.83
2024-12-02 17:51:13+00:00,Transport,0.5,0.0,19432.33
2024-12-02 18:17:33+00:00,Market,10.0,0.0,19422.33
2024-12-03 03:09:53+00:00,Transport,1.0,0.0,19421.33
2024-12-03 04:05:17+00:00,Market,6.5,0.0,19414.83
2024-12-03 06:02:33+00:00,Transport,0.5,0.0,19414.33
2024-12-03 06:27:34+00:00,Transport,0.5,0.0,19413.83
2024-12-03 07:09:49+00:00,Taxi,2.5,0.0,19411.33
2024-12-03 07:21:45+00:00,Taxi,2.5,0.0,19408.83
2024-12-03 07:21:48+00:00,Transport,0.5,0.0,19408.33
2024-12-03 07:40:09+00:00,Business lunch,11.0,0.0,19397.33
2024-12-03 13:33:38+00:00,Coffe,6.0,0.0,19391.33
2024-12-03 14:30:51+00:00,Learning,8.0,0.0,19383.33
2024-12-03 15:36:29+00:00,Coffe,7.2,0.0,19376.13
2024-12-03 16:56:38+00:00,Health,7.5,0.0,19368.63
2024-12-03 17:34:15+00:00,Transport,1.0,0.0,19367.63
2024-12-04 02:49:23+00:00,Learning,3.0,0.0,19364.63
2024-12-04 03:06:29+00:00,Transport,1.0,0.0,19363.63
2024-12-04 06:47:31+00:00,Business lunch,13.0,0.0,19350.63
2024-12-04 08:04:07+00:00,Coffe,6.4,0.0,19344.23
2024-12-04 13:23:09+00:00,Coffe,5.6,0.0,19338.63
2024-12-04 19:31:50+00:00,Restuarant,16.0,0.0,19322.63
2024-12-04 19:31:52+00:00,Transport,1.0,0.0,19321.63
2024-12-05 03:01:54+00:00,Transport,1.0,0.0,19320.63
2024-12-05 06:55:34+00:00,Business lunch,9.0,0.0,19311.63
2024-12-05 08:02:32+00:00,Coffe,6.4,0.0,19305.23
2024-12-05 13:22:32+00:00,Coffe,6.0,0.0,19299.23
2024-12-05 15:45:59+00:00,Coffe,6.5,0.0,19292.73
2024-12-05 17:18:18+00:00,Transport,1.0,0.0,19291.73
2024-12-05 17:18:21+00:00,Health,1.0,0.0,19290.73
2024-12-06 04:19:08+00:00,Transport,1.0,0.0,19289.73
2024-12-06 05:02:44+00:00,Market,5.2,0.0,19284.53
2024-12-06 08:00:13+00:00,Coffe,6.4,0.0,19278.13
2024-12-06 13:09:25+00:00,Transport,0.5,0.0,19277.63
2024-12-06 16:10:26+00:00,Restuarant,40.0,0.0,19237.63
2024-12-06 16:28:22+00:00,Transport,1.0,0.0,19236.63
2024-12-07 07:14:46+00:00,Taxi,10.0,0.0,19226.63
2024-12-07 10:30:34+00:00,Taxi,8.0,0.0,19218.63
2024-12-07 10:30:36+00:00,Taxi,11.0,0.0,19207.63
2024-12-07 10:30:39+00:00,Market,17.0,0.0,19190.63
2024-12-07 11:57:57+00:00,Taxi,4.0,0.0,19186.63
2024-12-07 12:29:27+00:00,Taxi,5.0,0.0,19181.63
2024-12-07 13:49:48+00:00,Transport,0.7,0.0,19180.93
2024-12-07 14:26:26+00:00,Coffe,6.0,0.0,19174.93
2024-12-07 16:00:39+00:00,Coffe,7.0,0.0,19167.93
2024-12-07 16:39:04+00:00,Transport,1.0,0.0,19166.93
2024-12-07 17:20:29+00:00,Market,5.0,0.0,19161.93
2024-12-08 08:34:47+00:00,Transport,1.0,0.0,19160.93
2024-12-08 09:23:09+00:00,Market,3.0,0.0,19157.93
2024-12-08 09:39:59+00:00,Coffe,5.6,0.0,19152.33
2024-12-08 12:00:54+00:00,Restuarant,8.0,0.0,19144.33
2024-12-08 12:14:11+00:00,Coffe,5.0,0.0,19139.33
2024-12-08 15:37:29+00:00,Transport,0.5,0.0,19138.83
2024-12-08 16:28:49+00:00,Market,8.0,0.0,19130.83
2024-12-08 17:04:55+00:00,Other,15.0,0.0,19115.83
2024-12-09 03:14:29+00:00,Transport,1.0,0.0,19114.83
2024-12-09 04:01:58+00:00,Learning,5.0,0.0,19109.83
2024-12-09 06:14:59+00:00,Restuarant,7.2,0.0,19102.63
2024-12-09 06:17:46+00:00,Market,1.0,0.0,19101.63
2024-12-09 08:09:59+00:00,Coffe,7.0,0.0,19094.63
2024-12-09 13:12:20+00:00,Coffe,6.0,0.0,19088.63
2024-12-09 17:32:19+00:00,Transport,1.0,0.0,19087.63
2024-12-09 18:19:36+00:00,Market,9.0,0.0,19078.63
2024-12-10 05:53:52+00:00,Transport,1.0,0.0,19077.63
2024-12-10 08:24:00+00:00,Business lunch,10.0,0.0,19067.63
2024-12-10 13:24:10+00:00,Coffe,6.0,0.0,19061.63
2024-12-10 15:50:48+00:00,Transport,1.0,0.0,19060.63
2024-12-10 16:39:25+00:00,Market,2.0,0.0,19058.63
2024-12-11 03:16:37+00:00,Transport,1.0,0.0,19057.63
2024-12-11 07:25:53+00:00,Transport,1.0,0.0,19056.63
2024-12-11 08:08:01+00:00,Transport,1.0,0.0,19055.63
2024-12-11 09:17:19+00:00,Business lunch,10.0,0.0,19045.63
2024-12-11 13:29:48+00:00,Coffe,6.0,0.0,19039.63
2024-12-11 13:47:33+00:00,Communal,1.0,0.0,19038.63
2024-12-11 16:24:17+00:00,Coffe,3.5,0.0,19035.13
2024-12-11 18:18:56+00:00,Market,9.0,0.0,19026.13
2024-12-12 03:10:48+00:00,Transport,1.0,0.0,19025.13
2024-12-12 06:47:42+00:00,Business lunch,15.0,0.0,19010.13
2024-12-12 08:02:38+00:00,Coffe,6.4,0.0,19003.73
2024-12-12 13:26:30+00:00,Coffe,5.6,0.0,18998.13
2024-12-12 16:02:42+00:00,Transport,1.0,0.0,18997.13
2024-12-13 03:43:18+00:00,Transport,1.0,0.0,18996.13
2024-12-13 06:45:41+00:00,Business lunch,7.2,0.0,18988.93
2024-12-13 08:08:42+00:00,Coffe,6.4,0.0,18982.53
2024-12-13 13:22:32+00:00,Coffe,5.6,0.0,18976.93
2024-12-13 13:59:02+00:00,Coffe,7.2,0.0,18969.73
2024-12-13 15:45:23+00:00,Transport,1.0,0.0,18968.73
2024-12-13 16:31:17+00:00,Market,2.0,0.0,18966.73
2024-12-13 17:11:51+00:00,Learning,170.0,0.0,18796.73
2024-12-14 08:19:22+00:00,Transport,1.0,0.0,18795.73
2024-12-14 08:52:57+00:00,Transport,0.5,0.0,18795.23
2024-12-14 09:53:39+00:00,Taxi,5.0,0.0,18790.23
2024-12-14 10:29:30+00:00,Coffe,6.0,0.0,18784.23
2024-12-14 12:25:21+00:00,Coffe,13.0,0.0,18771.23
2024-12-14 14:47:08+00:00,Transport,1.0,0.0,18770.23
2024-12-14 15:34:47+00:00,Market,20.0,0.0,18750.23
2024-12-15 09:06:01+00:00,Transport,1.0,0.0,18749.23
2024-12-15 10:00:18+00:00,Coffe,6.0,0.0,18743.23
2024-12-15 12:33:15+00:00,Coffe,15.0,0.0,18728.23
2024-12-15 12:52:55+00:00,Phone,20.0,0.0,18708.23
2024-12-15 14:23:06+00:00,Transport,1.0,0.0,18707.23
2024-12-15 14:58:11+00:00,Other,15.0,0.0,18692.23
2024-12-15 15:11:24+00:00,Market,6.63,0.0,18685.6
2024-12-16 05:58:22+00:00,Transport,1.0,0.0,18684.6
2024-12-16 06:50:29+00:00,Restuarant,20.0,0.0,18664.6
2024-12-16 07:02:55+00:00,Coffe,5.0,0.0,18659.6
2024-12-16 08:12:36+00:00,Transport,1.0,0.0,18658.6
2024-12-16 10:33:58+00:00,Business lunch,10.0,0.0,18648.6
2024-12-16 11:01:25+00:00,Coffe,5.0,0.0,18643.6
2024-12-16 12:07:14+00:00,Coffe,5.0,0.0,18638.6
2024-12-16 17:58:22+00:00,Transport,1.0,0.0,18637.6
2024-12-16 18:35:59+00:00,Market,5.4,0.0,18632.2
2024-12-17 02:56:56+00:00,Transport,1.0,0.0,18631.2
2024-12-17 08:35:45+00:00,Business lunch,10.0,0.0,18621.2
2024-12-17 08:35:50+00:00,Market,15.0,0.0,18606.2
2024-12-17 08:40:37+00:00,Coffe,6.4,0.0,18599.8
2024-12-17 13:03:56+00:00,Transport,1.0,0.0,18598.8
2024-12-17 13:42:49+00:00,Coffe,9.0,0.0,18589.8
2024-12-17 18:03:39+00:00,Restuarant,152.0,0.0,18437.8
2024-12-17 18:05:57+00:00,Transport,1.0,0.0,18436.8
2024-12-18 03:01:00+00:00,Transport,1.0,0.0,18435.8
2024-12-18 06:18:24+00:00,Business lunch,7.0,0.0,18428.8
2024-12-18 08:01:23+00:00,Coffe,6.4,0.0,18422.4
2024-12-18 11:45:54+00:00,Phone,3.0,0.0,18419.4
2024-12-18 13:24:39+00:00,Coffe,13.0,0.0,18406.4
2024-12-18 17:53:47+00:00,Transport,1.0,0.0,18405.4
2024-12-18 18:43:58+00:00,Market,10.0,0.0,18395.4
2024-12-19 03:12:01+00:00,Transport,1.0,0.0,18394.4
2024-12-19 06:19:17+00:00,Business lunch,7.2,0.0,18387.2
2024-12-19 08:04:06+00:00,Coffe,6.4,0.0,18380.8
2024-12-19 17:36:36+00:00,Transport,1.0,0.0,18379.8
2024-12-20 03:03:15+00:00,Transport,1.0,0.0,18378.8
2024-12-20 06:13:18+00:00,Business lunch,10.0,0.0,18368.8
2024-12-20 09:05:21+00:00,Coffe,5.0,0.0,18363.8
2024-12-20 13:21:25+00:00,Coffe,9.2,0.0,18354.6
2024-12-20 15:38:07+00:00,Transport,1.0,0.0,18353.6
2024-12-20 16:17:22+00:00,Restuarant,9.0,0.0,18344.6
2024-12-20 16:37:06+00:00,Market,12.0,0.0,18332.6
2024-12-21 08:53:10+00:00,Phone,20.0,0.0,18312.6
2024-12-21 09:45:02+00:00,Phone,5.0,0.0,18307.6
2024-12-21 09:45:04+00:00,Transport,1.0,0.0,18306.6
2024-12-21 10:42:24+00:00,Market,1.55,0.0,18305.05
2024-12-21 10:42:28+00:00,Coffe,6.0,0.0,18299.05
2024-12-21 14:42:37+00:00,business_expenses,35.0,0.0,18264.05
2024-12-21 16:22:39+00:00,Coffe,14.0,0.0,18250.05
2024-12-21 16:30:35+00:00,Transport,1.0,0.0,18249.05
2024-12-21 17:25:55+00:00,Market,20.0,0.0,18229.05
2024-12-22 08:17:22+00:00,Transport,1.0,0.0,18228.05
2024-12-22 09:24:36+00:00,Coffe,5.6,0.0,18222.45
2024-12-22 11:48:00+00:00,Restuarant,15.0,0.0,18207.45
2024-12-22 12:10:47+00:00,Transport,1.0,0.0,18206.45
2024-12-22 12:35:07+00:00,Market,8.3,0.0,18198.15
2024-12-22 12:43:14+00:00,Coffe,10.0,0.0,18188.15
2024-12-22 14:47:20+00:00,Transport,1.0,0.0,18187.15
2024-12-22 15:19:55+00:00,Market,9.0,0.0,18178.15
2024-12-23 03:12:55+00:00,Transport,1.0,0.0,18177.15
2024-12-23 06:22:05+00:00,Business lunch,7.7,0.0,18169.45
2024-12-23 08:18:42+00:00,Taxi,2.5,0.0,18166.95
2024-12-23 10:12:36+00:00,Business lunch,16.0,0.0,18150.95
2024-12-23 10:23:32+00:00,Transport,1.0,0.0,18149.95
2024-12-23 10:52:45+00:00,Coffe,5.0,0.0,18144.95
2024-12-23 12:12:54+00:00,Coffe,5.6,0.0,18139.35
2024-12-23 15:31:50+00:00,Coffe,8.5,0.0,18130.85
2024-12-23 17:14:50+00:00,Coffe,8.0,0.0,18122.85
2024-12-23 17:43:57+00:00,Transport,1.0,0.0,18121.85
2024-12-23 18:33:37+00:00,Market,7.0,0.0,18114.85
2024-12-24 02:59:03+00:00,Transport,1.0,0.0,18113.85
2024-12-24 07:08:10+00:00,Business lunch,8.0,0.0,18105.85
2024-12-24 08:05:34+00:00,Coffe,6.4,0.0,18099.45
2024-12-24 12:58:20+00:00,Transport,2.0,0.0,18097.45
2024-12-24 16:03:34+00:00,Transport,1.0,0.0,18096.45
2024-12-24 16:03:38+00:00,Restuarant,31.0,0.0,18065.45
2024-12-25 11:15:07+00:00,Transport,1.0,0.0,18064.45
2024-12-25 11:58:57+00:00,Coffe,7.0,0.0,18057.45
2024-12-25 16:52:17+00:00,Transport,1.0,0.0,18056.45
2024-12-25 16:52:19+00:00,Coffe,15.0,0.0,18041.45
2024-12-25 17:49:15+00:00,Market,12.0,0.0,18029.45
2024-12-26 03:01:21+00:00,Transport,1.0,0.0,18028.45
2024-12-26 03:38:23+00:00,Market,2.4,0.0,18026.05
2024-12-26 06:19:24+00:00,Transport,1.0,0.0,18025.05
2024-12-26 07:02:36+00:00,Business lunch,8.5,0.0,18016.55
2024-12-26 08:13:46+00:00,Learning,24.0,0.0,17992.55
2024-12-26 13:27:01+00:00,Transport,1.0,0.0,17991.55
2024-12-27 03:10:01+00:00,Transport,1.0,0.0,17990.55
2024-12-27 03:38:24+00:00,Market,7.7,0.0,17982.85
2024-12-27 08:11:08+00:00,Market,1.1,0.0,17981.75
2024-12-27 08:14:48+00:00,Coffe,13.13,0.0,17968.62
2024-12-27 18:30:17+00:00,Restuarant,50.0,0.0,17918.62
2024-12-27 18:40:57+00:00,Transport,1.0,0.0,17917.62
2024-12-28 03:38:03+00:00,Market,2.4,0.0,17915.22
2024-12-28 08:44:05+00:00,Business lunch,10.0,0.0,17905.22
2024-12-28 11:14:58+00:00,Tech,12.0,0.0,17893.22
2024-12-28 11:15:03+00:00,Market,4.7,0.0,17888.52
2024-12-28 13:14:21+00:00,Transport,1.0,0.0,17887.52
2024-12-28 14:23:44+00:00,Other,15.0,0.0,17872.52
2024-12-29 03:59:17+00:00,Transport,1.0,0.0,17871.52
2024-12-29 04:50:42+00:00,Market,5.5,0.0,17866.02
2024-12-29 05:46:17+00:00,Phone,20.0,0.0,17846.02
2024-12-29 07:00:49+00:00,Restuarant,13.5,0.0,17832.52
2024-12-29 08:18:11+00:00,Coffe,6.4,0.0,17826.12
2024-12-29 16:43:29+00:00,Coffe,40.0,0.0,17786.12
2024-12-29 17:02:15+00:00,Restuarant,6.5,0.0,17779.62
2024-12-29 17:06:12+00:00,Transport,1.0,0.0,17778.62
2024-12-29 18:05:32+00:00,Market,15.0,0.0,17763.62
2024-12-30 10:41:28+00:00,Transport,1.0,0.0,17762.62
2024-12-30 11:47:18+00:00,Coffe,9.2,0.0,17753.42
2024-12-30 15:30:54+00:00,Restuarant,10.0,0.0,17743.42
2024-12-30 15:31:54+00:00,Transport,1.0,0.0,17742.42
2024-12-30 16:20:37+00:00,Market,22.0,0.0,17720.42
2024-12-31 01:33:42+00:00,Salary,0.0,7000.0,24720.42
2024-12-31 05:40:21+00:00,Market,9.0,0.0,24711.42
2024-12-31 05:40:24+00:00,Taxi,4.0,0.0,24707.42
2024-12-31 06:08:09+00:00,Coffe,9.2,0.0,24698.22
2024-12-31 08:55:15+00:00,Coffe,12.0,0.0,24686.22
2024-12-31 11:08:29+00:00,Coffe,18.4,0.0,24667.82
2024-12-31 13:55:09+00:00,Transport,1.0,0.0,24666.82
2024-12-31 14:00:50+00:00,Market,23.0,0.0,24643.82
2025-01-01 08:06:45+00:00,Taxi,6.0,0.0,24637.82
2025-01-01 08:31:13+00:00,Coffe,18.4,0.0,24619.42
2025-01-01 12:04:51+00:00,Coffe,11.0,0.0,24608.42
2025-01-01 14:34:42+00:00,Transport,1.0,0.0,24607.42
2025-01-01 15:02:08+00:00,Market,7.0,0.0,24600.42
2025-01-02 05:23:09+00:00,Market,5.0,0.0,24595.42
2025-01-02 05:32:41+00:00,Taxi,4.0,0.0,24591.42
2025-01-02 05:32:52+00:00,Market,5.0,0.0,24586.42
2025-01-02 05:40:26+00:00,Coffe,12.0,0.0,24574.42
2025-01-02 08:48:28+00:00,Coffe,17.0,0.0,24557.42
2025-01-02 10:53:09+00:00,Taxi,4.0,0.0,24553.42
2025-01-02 10:53:20+00:00,Market,12.0,0.0,24541.42
2025-01-03 08:12:31+00:00,Market,1.0,0.0,24540.42
2025-01-03 08:12:33+00:00,Taxi,4.0,0.0,24536.42
2025-01-03 08:57:30+00:00,Coffe,18.4,0.0,24518.02
2025-01-03 11:20:36+00:00,Clothing,99.0,0.0,24419.02
2025-01-03 11:53:47+00:00,Taxi,4.0,0.0,24415.02
2025-01-03 13:36:33+00:00,Communal,25.0,0.0,24390.02
2025-01-04 09:38:25+00:00,Taxi,4.0,0.0,24386.02
2025-01-04 10:05:58+00:00,Coffe,12.0,0.0,24374.02
2025-01-04 15:08:41+00:00,Restuarant,20.0,0.0,24354.02
2025-01-04 15:40:07+00:00,Clothing,70.0,0.0,24284.02
2025-01-04 16:07:03+00:00,Transport,1.0,0.0,24283.02
2025-01-04 16:55:04+00:00,Market,6.14,0.0,24276.88
2025-01-05 08:16:17+00:00,Taxi,4.0,0.0,24272.88
2025-01-05 08:17:07+00:00,Market,1.0,0.0,24271.88
2025-01-05 08:38:08+00:00,Coffe,12.0,0.0,24259.88
2025-01-05 11:33:12+00:00,Coffe,17.0,0.0,24242.88
2025-01-05 13:14:05+00:00,Market,16.0,0.0,24226.88
2025-01-06 03:04:43+00:00,Transport,1.0,0.0,24225.88
2025-01-06 03:46:06+00:00,Market,3.4,0.0,24222.48
2025-01-06 06:28:21+00:00,Business lunch,10.0,0.0,24212.48
2025-01-06 08:00:27+00:00,Coffe,6.4,0.0,24206.08
2025-01-06 10:47:25+00:00,Market,12.0,0.0,24194.08
2025-01-06 13:18:21+00:00,Coffe,5.6,0.0,24188.48
2025-01-06 16:33:00+00:00,Transport,1.0,0.0,24187.48
2025-01-06 17:33:02+00:00,Market,8.7,0.0,24178.78
2025-01-07 03:00:37+00:00,Transport,1.0,0.0,24177.78
2025-01-07 03:39:53+00:00,Market,2.4,0.0,24175.38
2025-01-07 08:38:02+00:00,Business lunch,10.0,0.0,24165.38
2025-01-07 08:48:29+00:00,Clothing,49.0,0.0,24116.38
2025-01-08 03:11:29+00:00,Transport,1.0,0.0,24115.38
2025-01-08 03:47:58+00:00,Market,2.4,0.0,24112.98
2025-01-08 06:22:36+00:00,Business lunch,8.0,0.0,24104.98
2025-01-08 08:00:01+00:00,Coffe,6.4,0.0,24098.58
2025-01-08 13:26:02+00:00,Coffe,19.0,0.0,24079.58
2025-01-08 18:34:13+00:00,Transport,1.0,0.0,24078.58
2025-01-09 03:04:41+00:00,Transport,1.0,0.0,24077.58
2025-01-09 03:58:34+00:00,Market,2.4,0.0,24075.18
2025-01-09 08:00:07+00:00,Market,7.2,0.0,24067.98
2025-01-09 08:05:56+00:00,Market,8.0,0.0,24059.98
2025-01-09 08:39:07+00:00,Business lunch,10.0,0.0,24049.98
2025-01-09 08:43:59+00:00,Health,5.0,0.0,24044.98
2025-01-09 13:08:50+00:00,Transport,1.0,0.0,24043.98
2025-01-09 15:10:51+00:00,Other,15.0,0.0,24028.98
2025-01-10 03:17:53+00:00,Taxi,8.0,0.0,24020.98
2025-01-10 08:46:01+00:00,Business lunch,10.0,0.0,24010.98
2025-01-10 12:32:24+00:00,Taxi,4.0,0.0,24006.98
2025-01-10 12:54:51+00:00,Coffe,8.2,0.0,23998.78
2025-01-10 17:19:23+00:00,Other,5.0,0.0,23993.78
2025-01-10 18:17:40+00:00,Taxi,7.0,0.0,23986.78
2025-01-11 05:58:07+00:00,Transport,1.0,0.0,23985.78
2025-01-11 08:15:41+00:00,Taxi,4.0,0.0,23981.78
2025-01-11 08:15:44+00:00,Events,20.0,0.0,23961.78
2025-01-11 11:27:14+00:00,Restuarant,33.0,0.0,23928.78
2025-01-11 13:00:04+00:00,Market,25.0,0.0,23903.78
2025-01-12 09:31:45+00:00,Transport,1.0,0.0,23902.78
2025-01-12 10:23:47+00:00,Coffe,13.0,0.0,23889.78
2025-01-12 11:11:00+00:00,Coffe,4.0,0.0,23885.78
2025-01-12 14:57:48+00:00,Learning,11.0,0.0,23874.78
2025-01-12 14:58:08+00:00,Transport,1.0,0.0,23873.78
2025-01-12 15:46:15+00:00,Market,13.0,0.0,23860.78
2025-01-13 03:10:30+00:00,Transport,1.0,0.0,23859.78
2025-01-13 03:36:54+00:00,Market,2.4,0.0,23857.38
2025-01-13 08:56:56+00:00,Business lunch,10.0,0.0,23847.38
2025-01-13 13:17:31+00:00,Coffe,9.0,0.0,23838.38
2025-01-13 17:47:39+00:00,Coffe,10.0,0.0,23828.38
2025-01-13 17:47:41+00:00,Transport,1.0,0.0,23827.38
2025-01-13 18:11:43+00:00,Market,18.0,0.0,23809.38
2025-01-14 03:10:36+00:00,Transport,1.0,0.0,23808.38
2025-01-14 03:44:59+00:00,Market,3.4,0.0,23804.98
2025-01-14 04:31:19+00:00,Clothing,30.0,0.0,23774.98
2025-01-14 05:12:38+00:00,Phone,3.54,0.0,23771.44
2025-01-14 06:53:36+00:00,Market,11.0,0.0,23760.44
2025-01-14 07:19:37+00:00,Phone,4.0,0.0,23756.44
2025-01-14 07:55:11+00:00,Taxi,2.6,0.0,23753.84
2025-01-14 08:19:48+00:00,Taxi,2.6,0.0,23751.24
2025-01-14 08:43:36+00:00,Business lunch,12.0,0.0,23739.24
2025-01-14 13:20:21+00:00,Coffe,8.0,0.0,23731.24
2025-01-14 16:53:56+00:00,Transport,1.0,0.0,23730.24
2025-01-14 17:47:20+00:00,Market,12.0,0.0,23718.24
2025-01-15 03:02:28+00:00,Transport,1.0,0.0,23717.24
2025-01-15 03:36:23+00:00,Market,5.0,0.0,23712.24
2025-01-15 07:06:30+00:00,Business lunch,8.1,0.0,23704.14
2025-01-15 08:04:36+00:00,Coffe,6.0,0.0,23698.14
2025-01-15 13:04:37+00:00,Transport,1.0,0.0,23697.14
2025-01-16 03:10:05+00:00,Transport,1.0,0.0,23696.14
2025-01-16 03:37:57+00:00,Market,5.1,0.0,23691.04
2025-01-16 08:20:26+00:00,Business lunch,10.0,0.0,23681.04
2025-01-16 08:54:30+00:00,Market,8.0,0.0,23673.04
2025-01-16 13:22:43+00:00,Coffe,9.2,0.0,23663.84
2025-01-16 15:50:52+00:00,Coffe,12.0,0.0,23651.84
2025-01-16 17:26:03+00:00,Transport,1.0,0.0,23650.84
2025-01-16 18:22:44+00:00,Market,7.12,0.0,23643.72
2025-01-17 04:16:10+00:00,Transport,1.0,0.0,23642.72
2025-01-17 08:45:24+00:00,Business lunch,10.0,0.0,23632.72
2025-01-17 09:54:10+00:00,Phone,20.0,0.0,23612.72
2025-01-17 12:59:34+00:00,Transport,1.0,0.0,23611.72
2025-01-17 16:12:51+00:00,Transport,1.0,0.0,23610.72
2025-01-17 17:02:57+00:00,Market,32.0,0.0,23578.72
2025-01-18 05:47:24+00:00,Transport,1.0,0.0,23577.72
2025-01-18 06:35:21+00:00,Coffe,12.0,0.0,23565.72
2025-01-18 09:05:57+00:00,Restuarant,3.0,0.0,23562.72
2025-01-18 12:57:42+00:00,Transport,1.0,0.0,23561.72
2025-01-18 13:46:33+00:00,Market,9.0,0.0,23552.72
2025-01-19 05:24:56+00:00,Transport,1.0,0.0,23551.72
2025-01-19 06:21:04+00:00,Coffe,10.0,0.0,23541.72
2025-01-19 06:54:12+00:00,Learning,20.0,0.0,23521.72
2025-01-19 10:03:29+00:00,Transport,1.0,0.0,23520.72
2025-01-19 11:21:57+00:00,Other,15.0,0.0,23505.72
2025-01-20 04:54:54+00:00,Transport,1.0,0.0,23504.72
2025-01-20 05:46:42+00:00,Coffe,14.0,0.0,23490.72
2025-01-20 10:00:50+00:00,Restuarant,6.5,0.0,23484.22
2025-01-20 10:40:09+00:00,Coffe,2.0,0.0,23482.22
2025-01-20 14:56:38+00:00,Transport,1.0,0.0,23481.22
2025-01-20 15:35:43+00:00,Market,5.0,0.0,23476.22
2025-01-21 03:09:07+00:00,Transport,1.0,0.0,23475.22
2025-01-21 03:42:47+00:00,Market,3.4,0.0,23471.82
2025-01-21 08:57:44+00:00,Restuarant,16.0,0.0,23455.82
2025-01-21 13:19:11+00:00,Coffe,10.0,0.0,23445.82
2025-01-21 16:27:00+00:00,Transport,1.0,0.0,23444.82
2025-01-22 03:09:02+00:00,Transport,1.0,0.0,23443.82
2025-01-22 08:28:11+00:00,Business lunch,10.0,0.0,23433.82
2025-01-22 08:39:05+00:00,Learning,17.0,0.0,23416.82
2025-01-22 13:18:17+00:00,Coffe,11.2,0.0,23405.62
2025-01-22 16:13:38+00:00,Transport,1.0,0.0,23404.62
2025-01-22 17:25:25+00:00,Market,9.0,0.0,23395.62
2025-01-23 03:11:02+00:00,Transport,0.5,0.0,23395.12
2025-01-23 03:42:39+00:00,Market,3.4,0.0,23391.72
2025-01-23 08:47:06+00:00,Restuarant,24.0,0.0,23367.72
2025-01-23 13:12:47+00:00,Coffe,12.0,0.0,23355.72
2025-01-23 16:14:30+00:00,Transport,0.5,0.0,23355.22
2025-01-23 16:57:24+00:00,Market,5.0,0.0,23350.22
2025-01-24 04:34:05+00:00,Transport,1.0,0.0,23349.22
2025-01-24 08:49:21+00:00,Restuarant,35.0,0.0,23314.22
2025-01-24 09:59:44+00:00,Transport,0.5,0.0,23313.72
2025-01-24 09:59:49+00:00,Restuarant,22.0,0.0,23291.72
2025-01-24 13:02:43+00:00,Transport,0.5,0.0,23291.22
2025-01-24 13:22:36+00:00,Coffe,12.0,0.0,23279.22
2025-01-24 19:01:15+00:00,Restuarant,37.0,0.0,23242.22
2025-01-25 04:27:45+00:00,Transport,0.5,0.0,23241.72
2025-01-25 05:16:36+00:00,Transport,0.5,0.0,23241.22
2025-01-25 08:08:22+00:00,Coffe,15.0,0.0,23226.22
2025-01-25 12:26:11+00:00,Transport,0.5,0.0,23225.72
2025-01-25 13:08:08+00:00,Market,10.0,0.0,23215.72
2025-01-26 06:20:43+00:00,Transport,0.5,0.0,23215.22
2025-01-26 07:09:16+00:00,Restuarant,7.0,0.0,23208.22
2025-01-26 10:39:08+00:00,Restuarant,6.5,0.0,23201.72
2025-01-26 11:41:53+00:00,Coffe,6.0,0.0,23195.72
2025-01-26 15:52:53+00:00,Events,40.0,0.0,23155.72
2025-01-26 18:39:23+00:00,Market,5.34,0.0,23150.38
2025-01-27 03:17:29+00:00,Transport,0.5,0.0,23149.88
2025-01-27 07:07:58+00:00,Market,16.0,0.0,23133.88
2025-01-27 08:32:21+00:00,Restuarant,10.0,0.0,23123.88
2025-01-27 14:10:55+00:00,Other,10.0,0.0,23113.88
2025-01-27 17:44:06+00:00,Events,200.0,0.0,22913.88
2025-01-27 18:07:14+00:00,Taxi,4.1,0.0,22909.78
2025-01-28 05:38:43+00:00,Transport,1.0,0.0,22908.78
2025-01-28 08:57:11+00:00,Business lunch,10.0,0.0,22898.78
2025-01-28 13:25:13+00:00,Coffe,12.0,0.0,22886.78
2025-01-28 16:42:04+00:00,Transport,1.0,0.0,22885.78
2025-01-28 17:38:44+00:00,Market,2.0,0.0,22883.78
2025-01-29 08:48:33+00:00,Transport,0.5,0.0,22883.28
2025-01-29 09:51:52+00:00,Coffe,12.0,0.0,22871.28
2025-01-29 16:37:14+00:00,Restuarant,60.0,0.0,22811.28
2025-01-29 19:15:29+00:00,Market,11.0,0.0,22800.28
2025-01-30 03:14:16+00:00,Transport,0.5,0.0,22799.78
2025-01-30 08:17:42+00:00,Business lunch,10.0,0.0,22789.78
2025-01-30 08:20:38+00:00,Coffe,6.4,0.0,22783.38
2025-01-30 09:55:55+00:00,Learning,13.0,0.0,22770.38
2025-01-30 12:57:47+00:00,Transport,0.5,0.0,22769.88
2025-01-30 13:43:54+00:00,Market,14.14,0.0,22755.74
2025-01-31 01:33:42+00:00,Salary,0.0,7000.0,29755.74
2025-01-31 03:13:18+00:00,Transport,0.5,0.0,29755.24
2025-01-31 03:48:03+00:00,Market,2.4,0.0,29752.84
2025-01-31 08:44:35+00:00,Business lunch,10.0,0.0,29742.84
2025-01-31 13:21:04+00:00,Coffe,10.0,0.0,29732.84
2025-01-31 16:28:41+00:00,Market,7.0,0.0,29725.84
2025-02-01 06:04:07+00:00,Phone,3.0,0.0,29722.84
2025-02-01 06:53:44+00:00,Transport,0.5,0.0,29722.34
2025-02-01 07:57:02+00:00,Coffe,12.0,0.0,29710.34
2025-02-01 10:15:13+00:00,Learning,41.0,0.0,29669.34
2025-02-01 11:32:53+00:00,Restuarant,12.0,0.0,29657.34
2025-02-01 13:41:20+00:00,Transport,0.5,0.0,29656.84
2025-02-02 07:12:08+00:00,Transport,0.5,0.0,29656.34
2025-02-02 10:38:51+00:00,Learning,31.0,0.0,29625.34
2025-02-02 11:25:00+00:00,Transport,0.5,0.0,29624.84
2025-02-02 13:25:09+00:00,Restuarant,25.0,0.0,29599.84
2025-02-02 13:54:18+00:00,Transport,0.5,0.0,29599.34
2025-02-02 14:34:51+00:00,Transport,0.5,0.0,29598.84
2025-02-03 02:15:46+00:00,Transport,0.5,0.0,29598.34
2025-02-03 02:57:00+00:00,Sport,90.0,0.0,29508.34
2025-02-03 04:49:51+00:00,Sport,20.0,0.0,29488.34
2025-02-03 06:47:52+00:00,Restuarant,7.7,0.0,29480.64
2025-02-03 08:52:42+00:00,Market,1.0,0.0,29479.64
2025-02-03 13:07:12+00:00,Transport,0.5,0.0,29479.14
2025-02-03 13:45:38+00:00,Transport,0.5,0.0,29478.64
2025-02-04 02:06:22+00:00,Transport,0.5,0.0,29478.14
2025-02-04 04:03:18+00:00,Market,7.25,0.0,29470.89
2025-02-04 08:38:12+00:00,Business lunch,10.0,0.0,29460.89
2025-02-04 09:03:22+00:00,Market,1.0,0.0,29459.89
2025-02-04 13:02:38+00:00,Transport,0.5,0.0,29459.39
2025-02-04 13:28:00+00:00,Transport,0.5,0.0,29458.89
2025-02-04 13:46:00+00:00,Market,4.6,0.0,29454.29
2025-02-05 02:08:28+00:00,Transport,0.5,0.0,29453.79
2025-02-05 03:53:46+00:00,Market,7.31,0.0,29446.48
2025-02-05 07:20:17+00:00,Business lunch,13.0,0.0,29433.48
2025-02-05 08:06:03+00:00,Coffe,5.78,0.0,29427.7
2025-02-05 13:38:28+00:00,Coffe,5.6,0.0,29422.1
2025-02-05 16:08:50+00:00,Transport,0.5,0.0,29421.6
2025-02-06 03:15:27+00:00,Transport,1.0,0.0,29420.6
2025-02-06 05:30:25+00:00,Restuarant,10.0,0.0,29410.6
2025-02-06 11:24:34+00:00,Restuarant,11.0,0.0,29399.6
2025-02-06 13:22:35+00:00,Coffe,5.6,0.0,29394.0
2025-02-06 13:47:35+00:00,Phone,3.0,0.0,29391.0
2025-02-06 18:08:53+00:00,Market,10.28,0.0,29380.72
2025-02-07 03:11:01+00:00,Transport,0.5,0.0,29380.22
2025-02-07 03:11:04+00:00,Transport,0.5,0.0,29379.72
2025-02-07 05:32:44+00:00,Restuarant,10.7,0.0,29369.02
2025-02-07 07:54:28+00:00,Restuarant,7.0,0.0,29362.02
2025-02-07 14:58:14+00:00,Coffe,45.0,0.0,29317.02
2025-02-07 18:14:37+00:00,Transport,1.0,0.0,29316.02
2025-02-08 05:51:07+00:00,Learning,18.0,0.0,29298.02
2025-02-08 06:04:00+00:00,Market,7.0,0.0,29291.02
2025-02-08 08:29:06+00:00,Coffe,6.0,0.0,29285.02
2025-02-08 12:15:46+00:00,Transport,1.0,0.0,29284.02
2025-02-08 12:28:58+00:00,Market,13.5,0.0,29270.52
2025-02-09 05:24:07+00:00,Transport,1.0,0.0,29269.52
2025-02-09 07:20:00+00:00,Taxi,2.7,0.0,29266.82
2025-02-09 07:22:13+00:00,Coffe,15.6,0.0,29251.22
2025-02-09 11:05:29+00:00,Restuarant,33.0,0.0,29218.22
2025-02-09 18:12:59+00:00,Market,10.45,0.0,29207.77
2025-02-10 05:08:41+00:00,Restuarant,7.72,0.0,29200.05
2025-02-10 08:56:01+00:00,Market,9.0,0.0,29191.05
2025-02-10 13:03:59+00:00,Transport,1.0,0.0,29190.05
2025-02-10 16:03:47+00:00,Restuarant,45.0,0.0,29145.05
2025-02-10 16:16:43+00:00,Transport,0.5,0.0,29144.55
2025-02-11 02:52:49+00:00,Transport,0.5,0.0,29144.05
2025-02-11 03:04:54+00:00,Transport,0.5,0.0,29143.55
2025-02-11 06:00:22+00:00,Restuarant,6.5,0.0,29137.05
2025-02-11 08:42:49+00:00,Restuarant,6.0,0.0,29131.05
2025-02-11 13:19:15+00:00,Coffe,5.6,0.0,29125.45
2025-02-11 18:28:30+00:00,Transport,0.5,0.0,29124.95
2025-02-11 18:28:31+00:00,Market,4.0,0.0,29120.95
2025-02-12 04:00:47+00:00,Transport,0.5,0.0,29120.45
2025-02-12 04:06:31+00:00,Transport,0.5,0.0,29119.95
2025-02-12 09:54:13+00:00,Restuarant,17.0,0.0,29102.95
2025-02-12 17:02:46+00:00,Transport,0.5,0.0,29102.45
2025-02-13 02:11:08+00:00,Transport,0.5,0.0,29101.95
2025-02-13 04:19:47+00:00,Restuarant,8.0,0.0,29093.95
2025-02-13 08:51:47+00:00,Restuarant,10.0,0.0,29083.95
2025-02-13 12:53:55+00:00,Transport,0.5,0.0,29083.45
2025-02-13 13:38:49+00:00,Market,8.12,0.0,29075.33
2025-02-13 14:48:00+00:00,Other,15.0,0.0,29060.33
2025-02-14 03:58:13+00:00,Transport,0.5,0.0,29059.83
2025-02-14 04:13:37+00:00,Transport,0.5,0.0,29059.33
2025-02-14 04:50:00+00:00,Market,10.5,0.0,29048.83
2025-02-14 05:38:12+00:00,Restuarant,7.72,0.0,29041.11
2025-02-14 07:51:13+00:00,Phone,3.0,0.0,29038.11
2025-02-14 08:00:10+00:00,Market,3.8,0.0,29034.31
2025-02-14 13:01:01+00:00,Transport,0.5,0.0,29033.81
2025-02-14 17:44:59+00:00,Restuarant,35.0,0.0,28998.81
2025-02-14 18:29:47+00:00,Transport,1.0,0.0,28997.81
2025-02-15 06:27:49+00:00,Transport,0.5,0.0,28997.31
2025-02-15 06:38:51+00:00,Transport,0.5,0.0,28996.81
2025-02-15 08:02:36+00:00,Market,0.855,0.0,28995.955
2025-02-15 10:00:39+00:00,Transport,0.5,0.0,28995.455
2025-02-15 12:40:59+00:00,Restuarant,30.0,0.0,28965.455
2025-02-15 13:24:06+00:00,Transport,0.5,0.0,28964.955
2025-02-15 13:24:10+00:00,Transport,0.5,0.0,28964.455
2025-02-15 13:32:19+00:00,Market,3.84,0.0,28960.615
2025-02-16 09:09:50+00:00,Market,3.27,0.0,28957.345
2025-02-16 10:17:07+00:00,Coffe,17.7,0.0,28939.645
2025-02-16 15:42:02+00:00,Transport,0.5,0.0,28939.145
2025-02-16 15:42:04+00:00,Restuarant,30.0,0.0,28909.145
2025-02-16 17:41:06+00:00,Market,17.0,0.0,28892.145
2025-02-17 04:04:05+00:00,Phone,20.0,0.0,28872.145
2025-02-17 09:18:42+00:00,Market,16.58,0.0,28855.565
2025-02-17 13:40:31+00:00,Coffe,5.6,0.0,28849.965
2025-02-17 17:39:35+00:00,Transport,0.5,0.0,28849.465
2025-02-17 18:33:00+00:00,Market,24.66,0.0,28824.805
2025-02-18 03:09:54+00:00,Transport,0.5,0.0,28824.305
2025-02-19 03:13:53+00:00,Transport,0.5,0.0,28823.805
2025-02-19 17:39:55+00:00,Transport,0.5,0.0,28823.305
2025-02-19 18:46:29+00:00,Market,7.82,0.0,28815.485
2025-02-20 03:08:36+00:00,Transport,0.5,0.0,28814.985
2025-02-20 13:29:21+00:00,Transport,0.5,0.0,28814.485
2025-02-21 04:14:00+00:00,Transport,0.5,0.0,28813.985
2025-02-21 13:14:20+00:00,Transport,0.5,0.0,28813.485
2025-02-22 06:35:01+00:00,Transport,1.0,0.0,28812.485
2025-02-22 08:19:05+00:00,Transport,0.5,0.0,28811.985
2025-02-22 11:44:55+00:00,Restuarant,50.0,0.0,28761.985
2025-02-22 15:11:38+00:00,Restuarant,20.0,0.0,28741.985
2025-02-22 15:40:32+00:00,Transport,0.5,0.0,28741.485
2025-02-22 16:44:25+00:00,Taxi,4.4,0.0,28737.085
2025-02-22 17:49:08+00:00,Taxi,4.3,0.0,28732.785
2025-02-22 17:49:09+00:00,Market,2.0,0.0,28730.785
2025-02-23 08:44:46+00:00,Market,14.0,0.0,28716.785
2025-02-24 03:54:00+00:00,Transport,0.5,0.0,28716.285
2025-02-24 09:55:07+00:00,Restuarant,7.5,0.0,28708.785
2025-02-24 13:07:00+00:00,Transport,0.5,0.0,28708.285
2025-02-24 14:11:01+00:00,Market,8.0,0.0,28700.285
2025-02-25 03:21:25+00:00,Transport,0.5,0.0,28699.785
2025-02-25 13:13:00+00:00,Coffe,5.6,0.0,28694.185
2025-02-25 16:43:39+00:00,Taxi,4.4,0.0,28689.785
2025-02-25 17:07:35+00:00,Taxi,1.2,0.0,28688.585
2025-02-25 17:12:50+00:00,Market,8.65,0.0,28679.935
2025-02-26 03:05:25+00:00,Transport,0.5,0.0,28679.435
2025-02-26 07:47:00+00:00,Market,35.0,0.0,28644.435
2025-02-26 13:40:49+00:00,Coffe,6.6,0.0,28637.835
2025-02-26 17:15:36+00:00,Market,1.1,0.0,28636.735
2025-02-27 03:12:54+00:00,Transport,0.5,0.0,28636.235
2025-02-27 04:18:16+00:00,Market,1.8,0.0,28634.435
2025-02-27 08:03:26+00:00,Coffe,6.3,0.0,28628.135
2025-02-27 09:10:31+00:00,Coffe,11.55,0.0,28616.585
2025-02-27 13:30:55+00:00,Transport,0.5,0.0,28616.085
2025-02-27 15:34:32+00:00,Restuarant,30.0,0.0,28586.085
2025-02-28 01:33:42+00:00,Salary,0.0,7000.0,35586.085
2025-02-28 03:13:37+00:00,Transport,0.5,0.0,35585.585
2025-02-28 13:39:39+00:00,Coffe,6.6,0.0,35578.985
2025-02-28 15:14:10+00:00,Transport,0.5,0.0,35578.485
2025-03-01 11:15:17+00:00,Learning,40.5,0.0,35537.985
2025-03-01 12:49:25+00:00,Learning,28.9,0.0,35509.085
2025-03-01 12:53:46+00:00,Transport,0.5,0.0,35508.585
2025-03-01 13:56:30+00:00,Other,15.0,0.0,35493.585
2025-03-01 17:39:16+00:00,Market,13.51,0.0,35480.075
2025-03-02 16:06:55+00:00,Market,0.37,0.0,35479.705
2025-03-03 02:57:01+00:00,Transport,0.5,0.0,35479.205
2025-03-03 14:44:50+00:00,Coffe,13.5,0.0,35465.705
2025-03-03 18:34:28+00:00,Market,21.0,0.0,35444.705
2025-03-04 03:00:28+00:00,Transport,0.5,0.0,35444.205
2025-03-04 13:54:31+00:00,Transport,0.5,0.0,35443.705
2025-03-04 14:17:48+00:00,Market,4.34,0.0,35439.365
2025-03-05 02:52:13+00:00,Transport,0.5,0.0,35438.865
2025-03-05 12:32:15+00:00,Events,30.0,0.0,35408.865
2025-03-05 13:28:41+00:00,Transport,0.5,0.0,35408.365
2025-03-05 14:12:06+00:00,Phone,5.25,0.0,35403.115
2025-03-05 17:29:26+00:00,Transport,0.5,0.0,35402.615
2025-03-05 17:29:34+00:00,Restuarant,65.0,0.0,35337.615
2025-03-06 02:57:14+00:00,Transport,0.5,0.0,35337.115
2025-03-06 13:33:43+00:00,Transport,0.5,0.0,35336.615
2025-03-06 14:57:34+00:00,Coffe,15.0,0.0,35321.615
2025-03-06 16:13:09+00:00,Transport,0.5,0.0,35321.115
2025-03-06 16:29:36+00:00,Transport,0.5,0.0,35320.615
2025-03-06 16:45:35+00:00,Market,10.5,0.0,35310.115
2025-03-07 02:39:00+00:00,Transport,0.5,0.0,35309.615
2025-03-07 13:39:27+00:00,Transport,1.0,0.0,35308.615
2025-03-07 15:50:15+00:00,Events,60.0,0.0,35248.615
2025-03-07 17:17:53+00:00,Restuarant,30.0,0.0,35218.615
2025-03-07 18:12:03+00:00,Market,16.64,0.0,35201.975
2025-03-08 23:09:46+00:00,Market,12.6,0.0,35189.375
2025-03-09 10:44:00+00:00,Other,10.0,0.0,35179.375
2025-03-09 12:44:19+00:00,Transport,0.5,0.0,35178.875
2025-03-09 12:54:07+00:00,Transport,0.5,0.0,35178.375
2025-03-09 15:14:31+00:00,Restuarant,13.0,0.0,35165.375
2025-03-09 17:19:35+00:00,Transport,0.5,0.0,35164.875
2025-03-09 18:16:33+00:00,Market,2.88,0.0,35161.995
2025-03-10 02:50:47+00:00,Transport,0.5,0.0,35161.495
2025-03-10 13:25:19+00:00,Transport,0.5,0.0,35160.995
2025-03-10 14:21:57+00:00,Market,7.5,0.0,35153.495